########################################################
^                                                      #
^                                                      #
^                                                      #
#                                                      #
#                                            ###########
#                                            #         #
#  #########                                 #         #
#  #            ##############################   # #####
#  #       # ####                                #     #
#  #       #    #                                #     #
#  #       #   ##  ######     ################   #     #
#  #       #   ##       #        #  #        #   #  ## #
#  #       #  #####     #      #    #        #   #  ## #
#  #       #      #  ## #     #######  #######   #     #
####   ############     #              #         #   ###
#      #   #         #  #  ############# ## ######   ###
#            ############                   #          #
#      #  #  #  ##      #  #######################     #
#      #     #     ###       #   #    #        #       #
########     #############   # # # #  #        #  ##   #
#   # #####              #     #   #  l       ?#  ##   #
# #   l                  #    ##################       #
#  # ##################  #                             #
##  ##                   #                         ##  #
# #  ##########  #########   ###################   ##  #
### ##                   #                     #       #
##   #########################    ##         ""#       k
#  #                        !#               ""#  @    k
########################################################
