########################################################
#" D D     D #   D       D ##D    D  ##   D     ## D  "#
#  ##### D   #   D ## D    ##     ## ##       D ##     #
# D#####D D  #D    ## D D  ##  D  ## ##D  ##      D  D #
#  #####  D D   D  ##    D ##     ## ##   ##   D       #
#D #####    D     D## D D D  D   D## ##  D        D    #
#     D   ###############################   D     ##   #
#  D  #  D############################### D    D  ## D #
##      D       D   #    D  #        #     #           #
#  D  ##########    # "        D  D  #  D ### D   D D  #
##    ##########    #   ####   D           #   ######  #
##  D   D      D   D    ####D    ##      D    D######  #
#  #   ##  D   ##      D####    D##  D  #####  ######  #
#    D ##      ##  #### ####            #####  ######D #
#D  D   D   D  ##  D    D   D    D"##   #####D         #
##    D #####################################      D   #
#  ##   #################################    ##  D     #
#  ##     ##      #    D      D       "## D  ##     D  #
#    D    ## D    ##      #D   # D   # ##D##   D       #
#       D      #  #  #     ##    #D    ## ##     ###  D#
###    #    " ##     D   D ##       #D ##    D   ###   #
###     D#    ##        #      #       #### D    ###   #
# D         D      #        D      D   ####     D   D  #
#         #    #  D   ## #########   D ##  D   ## D    #
#   ##  D   ##        ##        D      ##      ##      #
#   ##      ## D # D    D    " #   D   ##         #### #
#      D                #        D D   ##D  ##  D ###  #
#  D     #  D   ##    D       #        ##   ##     ##  #
#                   #     D     D  D   ##"  D     D## @#
#####################################################kk#
